
# This line is a comment. For correct comment the very first character is '#'.
# Empty lines (zero length) are ignored.

# First line must represent map height. Second - map width.
# After that comes map line by line.

# Valid map characters:
# 'X' - wall;
# '.' - dot (pacman's food);
# 'o' - so called "energizer";
# ' ' - empty place;
# 'P' - pacman start place;
# '_' - door.

# Exactly one 'P' and exactly one '_' are allowed.
# Not less than one '.' must be present.
# Note that cell exactly below the door and cell exactly above the door must be empty.

31
28

XXXXXXXXXXXXXXXXXXXXXXXXXXXX
X            XX            X
X XXXX XXXXX XX XXXXX XXXX X
X XXXX XXXXX XX XXXXX XXXX X
X XXXX XXXXX XX XXXXX XXXX X
X                          X
X XXXX XX XXXXXXXX XX XXXX X
X XXXX XX XXXXXXXX XX XXXX X
X      XX    XX    XX      X
XXXXXX XXXXX XX XXXXX XXXXXX
     X XXXXX XX XXXXX X     
     X XX          XX X     
     X XX XXXX_XXX XX X     
XXXXXX XX X      X XX XXXXXX
          X      X          
XXXXXX XX X      X XX XXXXXX
     X XX XXXXXXXX XX X     
     X XX          XX X     
     X XX XXXXXXXX XX X     
XXXXXX XX XXXXXXXX XX XXXXXX
X            XX            X
X XXXX XXXXX XX XXXXX XXXX X
X XXXX XXXXX XX XXXXX XXXX X
X   XX   ...  P       XX   X
XXX XX XX.XXXXXXXX XX XX XXX
XXX XX XXoXXXXXXXX XX XX XXX
X      XX.   XX    XX      X
X XXXXXXXXXX XX XXXXXXXXXX X
X XXXXXXXXXX XX XXXXXXXXXX X
X                          X
XXXXXXXXXXXXXXXXXXXXXXXXXXXX