
# This line is a comment. For correct comment the very first character is '#'.
# Empty lines (zero length) are ignored.

# First line must represent map height. Second - map width.
# After that comes map line by line.

# Valid map characters:
# 'X' - wall;
# '.' - dot (pacman's food);
# 'o' - so called "energizer";
# ' ' - empty place;
# 'P' - pacman start place;
# '_' - door.

# Exactly one 'P' and exactly one '_' are allowed.
# Not less than one '.' must be present.
# Note that cell exactly below the door and cell exactly above the door must be empty.

31
28

XXXXXXXXXXXXXXXXXXXXXXXXXXXX
X......XX..........XX......X
XoXXXX.XX.XXXXXXXX.XX.XXXXoX
X.XXXX.XX.XXXXXXXX.XX.XXXX.X
X..........................X
XXX.XX.XXXXX.XX.XXXXX.XX.XXX
  X.XX.XXXXX.XX.XXXXX.XX.X  
XXX.XX.XXXXX.XX.XXXXX.XX.XXX
   .XX.......XX.......XX.   
XXX.XXXXX XXXXXXXX XXXXX.XXX
  X.XXXXX XXXXXXXX XXXXX.X  
  X......          ......X  
  X.XXXXX XXXX_XXX XXXXX.X  
  X.XXXXX X      X XXXXX.X  
  X.XX... X      X ...XX.X  
  X.XX.XX X      X XX.XX.X  
XXX.XX.XX XXXXXXXX XX.XX.XXX
   ....XX          XX....   
XXX.XXXXXXXX XX XXXXXXXX.XXX
  X.XXXXXXXX XX XXXXXXXX.X  
  X..........XX..........X  
  X XXXXX.XXXXXXXX.XXXXX.X  
XXX.XXXXX.XXXXXXXX.XXXXX.XXX
X.............P............X
X.XXXX.XXXXX.XX.XXXXX.XXXX.X
X.XXXX.XXXXX.XX.XXXXX.XXXX.X
X.XXXX.XX....XX....XX.XXXX.X
X.XXXX.XX.XXXXXXXX.XX.XXXX.X
XoXXXX.XX.XXXXXXXX.XX.XXXXoX
X..........................X
XXXXXXXXXXXXXXXXXXXXXXXXXXXX


