
# This line is a comment. For correct comment the very first character is '#'.
# Empty lines (zero length) are ignored.

# First line must represent map height. Second - map width.
# After that comes map line by line.

# Valid map characters:
# 'X' - wall;
# '.' - dot (pacman's food);
# 'o' - so called "energizer";
# ' ' - empty place;
# 'P' - pacman start place;
# '_' - door.

# Exactly one 'P' and exactly one '_' are allowed.
# Not less than one '.' must be present.
# Note that cell exactly below the door and cell exactly above the door must be empty.

31
28

XXXXXXXXXXXXXXXXXXXXXXXXXXXX
X..........................X
XoXX.XXXX.XXXXXXXX.XXXX.XXoX
X.XX.XXXX.XXXXXXXX.XXXX.XX.X
X.XX.XXXX.XX....XX.XXXX.XX.X
X.XX......XX.XX.XX......XX.X
X.XXXX.XX.XX.XX.XX.XX.XXXX.X
X.XXXX.XX.XX.XX.XX.XX.XXXX.X
X......XX....XX....XX......X
XXX.XXXXXXXX XX XXXXXXXX.XXX
  X.XXXXXXXX XX XXXXXXXX.X  
  X....XX          XX....X  
XXX XX.XX XXXX_XXX XX.XX XXX
    XX.XX X      X XX.XX    
XXXXXX.   X      X   .XXXXXX
XXXXXX.XX X      X XX.XXXXXX
    XX.XX XXXXXXXX XX.XX    
XXX XX.XX          XX.XX XXX
  X....XXXXX XX XXXXX....X  
  X.XX.XXXXX XX XXXXX.XX.X  
  X.XX.......XX.......XX.X  
  X.XXXXX.XX.XX.XX.XXXXX.X  
XXX.XXXXX.XX.XX.XX.XXXXX.XXX
Xo........XX..P.XX........oX
X.XXXX.XX.XXXXXXXX.XX.XXXX.X
X.XXXX.XX.XXXXXXXX.XX.XXXX.X
X.XX...XX..........XX...XX.X
X.XX.XXXXXXX.XX.XXXXXXX.XX.X
X.XX.XXXXXXX.XX.XXXXXXX.XX.X
X............XX............X
XXXXXXXXXXXXXXXXXXXXXXXXXXXX