
# This line is a comment. For correct comment the very first character is '#'.
# Empty lines (zero length) are ignored.

# First line must represent map height. Second - map width.
# After that comes map line by line.

# Valid map characters:
# 'X' - wall;
# '.' - dot (pacman's food);
# 'o' - so called "energizer";
# ' ' - empty place;
# 'P' - pacman start place;
# '_' - door.

# Exactly one 'P' and exactly one '_' are allowed.
# Not less than one '.' must be present.
# Note that cell exactly below the door and cell exactly above the door must be empty.

31
28

XXXXXXXXXXXXXXXXXXXXXXXXXXXX
X         XX    XX         X
X XXXX XX XX XX XX XX XXXX X
X XXXX XX XX XX XX XX XXXX X
X    o XX    XX    XX o    X
X XXXX XXXXX XX XXXXX XXXX X
X XXXX XXXXX XX XXXXX XXXX X
X XX         XX         XX X
X XX XXXX XXXXXXXX XXXX XX X
X XX XXXX XXXXXXXX XXXX XX X
  XX                    XX  
X XXXX XX XXXX_XXX XXXX XX X
X XXXX XX X      X XXXX XX X
X XXXX XX X      X XXXX XX X
X      XX X      X XX      X
X XXXX XX XXXXXXXX XX XXXX X
X XXXX XX          XX XXXX X
X   XX XX XXXXXXXX XX XX   X
XXX XX XX XXXXXXXX XX XX XXX
XXX XX       XX       XX XXX
    XX XXXXX XX XXXXX XX    
X XXXX XXXXX XX XXXXX XXXX X
X XXXX XX ..  P    XX XXXX X
X      XX XX XX XX XX      X
X XX XXXX XX XX XX XXXX XX X
X XX XXXX XX XX XX XXXX XX X
X XX o    XX    XX    o XX X
X XXXXXXX XXXXXXXX XXXXXXX X
X XXXXXXX XXXXXXXX XXXXXXX X
X                          X
XXXXXXXXXXXXXXXXXXXXXXXXXXXX


