
# This line is a comment. For correct comment the very first character is '#'.
# Empty lines (zero length) are ignored.

# First line must represent map height. Second - map width.
# After that comes map line by line.

# Valid map characters:
# 'X' - wall;
# '.' - dot (pacman's food);
# 'o' - so called "energizer";
# ' ' - empty place;
# 'P' - pacman start place;
# '_' - door.

# Exactly one 'P' and exactly one '_' are allowed.
# Not less than one '.' must be present.
# Note that cell exactly below the door and cell exactly above the door must be empty.

31
28


      XXXXXXXXXXXXXXXX      
      X              X      
      X XX XXXXXX XX X      
      X XX XXXXXX XX X      
      X XX   XX   XX X      
      X XXXX XX XXXX X      
XXXXXXX XXXX XX XXXX XXXXXXX
  o     XX        XX     o  
XXX XXXXXX XXXXXX XXXXXX XXX
XXX XXXXXX XXXXXX XXXXXX XXX
X       XX   XX   XX       X
X XXXXX XXXX XX XXXX XXXXX X
X XXXXX XXXX XX XXXX XXXXX X
X    XX              XX    X
XXXX XXXX XXXX_XXX XXXX XXXX
XXXX XXXX X      X XXXX XXXX
  XX      X      X      XX  
X XX XXXX X      X XXXX XX X
X    XXXX XXXXXXXX XXXX    X
X XX XX              XX XX X
X XX XX XXXXXXXXXXXX XX XX X
X XX XX XXXXXXXXXXXX XX XX X
  XX XX      XX      XX XX  
XXXX XXXXXXX XX XXXXXXX XXXX
XXXX XXXXXXX XX XXXXXXX XXXX
X          .. P            X
X XX XXXXXXXXXXXXXXXXXX XX X
XoXX X                X XXoX
X XX X                X XX X
X    X                X    X
XXXXXX                XXXXXX
